4111111113111111115
1000000001000000001
1044041401041404401
1044041402041404401
1000000000000000001
1022020213120202201
1000010001000100001
4115031202021305115
6661010000000101666
1115020420240205111
0000000100010000000
1115020411140205111
6661010000000101666
5115020213120205115
1000000001000000001
1025021202021204201
1001000000000001001
3202020213120202023
1000010001000100001
1021131202021311201
1000000000000000001
5111111111111111115